000000000000000000000000000000000000000000000000000000000000000000000000000000000000000000000000
000000000000000000000000000000000000000000000000000000000000000000000000000000000000000000000000
000000000000000000000004000000000000000000000000000000000000000000000000000000000000000000000000
111111111111111111111111111111111111111111111111111111111111111111111111111111113000000000000000
000000000000000000000000000000000000000000000000000000000000000000000000000000001111111111000000
000000000000000000000000000000000000000000000030000000000000000000000000000000000000000000000000
300000030303000000000000000000000000000000011111100000000000000000000000000000000000000300300111
111111111111111100000303000000000000000000000000000000000000000000000000000000000031111111111000
000000000000000011111111111100000030000000000000000000000000000000000000111111111110000000000000
000000000000000000000000000011111111111111110000000000000000000000000000000000000000000000000000
000000000000000000000000000000000000000000000000000000000000000000000000000000000000000000000000
000000000000000000000000000000000000000000000000000001111111100000000000000000000000000000000000
000000000000000000000000000000000000000030000111111110000000000111111110000030000000000000000000
000000000000000000000000000000003000011111111000000000000000000000000000111111110000300000000000
000000000000000000000000000001111111100000000000000000000000000000000000000000001111111100000000
000000000000000000011111111110000000000000000000000000000000000000000000000000000000000011111100
000000000000000000000000000010300030000000000000000000000000000000000000000000000000000000000000
303000000000000000000000000011111111111111100000000000000000000000000000000000000000000000000000
111111111111100000000000000003100000000000000000000000000000000000000000000000000000000000000000
000000000000000000000111111111100000000000000000000000000000000000000000000000000000000000000000
000000000000000000000000000000000000000000000000000000000001111110000000000000000000000000000001
000001111111111111100000000030000000000000000000000001111110000001111110000030000000000000000001
000110000000000000011111111111000000000003000001111110000000000000000001111110000000000000001111
111000000000000000000000000000000000000011111100000000000000000000000000000000000000000000000000